     0   Inf     4     7   Inf   Inf   Inf   Inf   Inf   Inf   Inf   Inf   Inf   Inf   Inf   Inf   Inf   Inf   Inf   Inf   Inf   Inf   Inf     4   Inf   Inf   Inf   Inf   Inf   Inf   Inf   Inf   Inf   Inf   Inf   Inf   Inf   Inf   Inf   Inf   Inf   Inf   Inf   Inf   Inf   Inf   Inf   Inf   Inf   Inf     5   Inf   Inf   Inf   Inf   Inf   Inf   Inf   Inf   Inf   Inf   Inf   Inf   Inf   Inf   Inf   Inf   Inf   Inf     6
   Inf     0   Inf   Inf   Inf   Inf   Inf   Inf   Inf     5   Inf     5   Inf   Inf   Inf   Inf     3   Inf   Inf   Inf   Inf   Inf   Inf   Inf   Inf   Inf     3   Inf   Inf   Inf   Inf     5   Inf   Inf   Inf   Inf   Inf   Inf   Inf   Inf   Inf   Inf   Inf   Inf   Inf   Inf   Inf   Inf   Inf     3   Inf   Inf   Inf   Inf   Inf   Inf   Inf   Inf   Inf     5   Inf   Inf   Inf   Inf   Inf   Inf   Inf   Inf     5   Inf
     4   Inf     0   Inf   Inf   Inf   Inf   Inf   Inf   Inf   Inf   Inf   Inf   Inf     7   Inf   Inf   Inf   Inf   Inf   Inf   Inf   Inf     6   Inf   Inf   Inf   Inf   Inf   Inf   Inf   Inf   Inf   Inf   Inf   Inf   Inf   Inf   Inf   Inf   Inf   Inf   Inf   Inf   Inf   Inf   Inf   Inf   Inf   Inf     4   Inf   Inf   Inf   Inf   Inf   Inf   Inf   Inf   Inf   Inf   Inf   Inf   Inf   Inf   Inf   Inf   Inf   Inf   Inf
     7   Inf   Inf     0   Inf   Inf   Inf   Inf   Inf   Inf   Inf   Inf   Inf   Inf   Inf   Inf   Inf   Inf   Inf     5   Inf   Inf   Inf     5   Inf   Inf   Inf   Inf   Inf     3   Inf   Inf   Inf   Inf   Inf   Inf   Inf   Inf     5   Inf   Inf   Inf   Inf   Inf   Inf   Inf   Inf   Inf     4   Inf   Inf   Inf   Inf   Inf   Inf   Inf   Inf   Inf   Inf   Inf   Inf   Inf   Inf   Inf   Inf   Inf     3   Inf   Inf     2
   Inf   Inf   Inf   Inf     0   Inf   Inf     4   Inf   Inf   Inf   Inf     5   Inf   Inf   Inf   Inf   Inf   Inf   Inf   Inf   Inf   Inf   Inf   Inf     5   Inf   Inf   Inf   Inf   Inf   Inf   Inf   Inf   Inf   Inf   Inf   Inf   Inf   Inf     5   Inf   Inf   Inf   Inf   Inf   Inf   Inf   Inf   Inf   Inf   Inf   Inf     5   Inf   Inf   Inf   Inf   Inf   Inf   Inf   Inf   Inf   Inf   Inf   Inf   Inf   Inf   Inf   Inf
   Inf   Inf   Inf   Inf   Inf     0   Inf   Inf   Inf   Inf   Inf   Inf   Inf   Inf   Inf   Inf   Inf   Inf     4   Inf   Inf   Inf   Inf   Inf   Inf   Inf   Inf   Inf   Inf   Inf   Inf   Inf     5   Inf   Inf   Inf   Inf     2   Inf   Inf   Inf   Inf   Inf   Inf   Inf   Inf   Inf   Inf   Inf   Inf   Inf   Inf   Inf   Inf     4   Inf   Inf   Inf   Inf   Inf   Inf   Inf   Inf   Inf   Inf     2   Inf     4   Inf   Inf
   Inf   Inf   Inf   Inf   Inf   Inf     0   Inf   Inf   Inf   Inf   Inf   Inf   Inf   Inf   Inf   Inf   Inf   Inf   Inf   Inf     7   Inf   Inf   Inf   Inf   Inf   Inf   Inf   Inf   Inf   Inf   Inf   Inf   Inf     6   Inf   Inf   Inf   Inf   Inf   Inf   Inf   Inf   Inf   Inf   Inf     6   Inf   Inf   Inf   Inf   Inf   Inf   Inf   Inf     5   Inf   Inf   Inf   Inf   Inf   Inf     5   Inf   Inf   Inf   Inf   Inf   Inf
   Inf   Inf   Inf   Inf     4   Inf   Inf     0   Inf   Inf   Inf   Inf   Inf   Inf   Inf   Inf   Inf   Inf   Inf   Inf   Inf   Inf   Inf   Inf   Inf   Inf   Inf   Inf   Inf   Inf   Inf   Inf   Inf   Inf   Inf   Inf   Inf   Inf   Inf   Inf     2   Inf   Inf   Inf   Inf   Inf     3     7   Inf   Inf   Inf   Inf   Inf     4   Inf   Inf   Inf   Inf   Inf   Inf   Inf   Inf   Inf   Inf   Inf   Inf   Inf   Inf   Inf   Inf
   Inf   Inf   Inf   Inf   Inf   Inf   Inf   Inf     0   Inf     5   Inf   Inf   Inf   Inf   Inf   Inf   Inf   Inf   Inf   Inf   Inf   Inf   Inf   Inf   Inf     5   Inf     2   Inf   Inf   Inf   Inf   Inf   Inf   Inf   Inf   Inf   Inf   Inf   Inf   Inf   Inf   Inf   Inf   Inf   Inf   Inf   Inf   Inf   Inf     5     4   Inf   Inf     5     3   Inf   Inf   Inf   Inf   Inf   Inf   Inf   Inf   Inf   Inf   Inf   Inf   Inf
   Inf     5   Inf   Inf   Inf   Inf   Inf   Inf   Inf     0   Inf     3   Inf   Inf   Inf   Inf     6     8   Inf   Inf   Inf   Inf   Inf   Inf   Inf   Inf   Inf   Inf   Inf   Inf   Inf     5   Inf   Inf   Inf   Inf   Inf   Inf   Inf   Inf   Inf   Inf   Inf   Inf   Inf   Inf   Inf   Inf   Inf     6   Inf   Inf   Inf   Inf   Inf   Inf   Inf   Inf   Inf     4   Inf   Inf   Inf   Inf   Inf   Inf   Inf   Inf     1   Inf
   Inf   Inf   Inf   Inf   Inf   Inf   Inf   Inf     5   Inf     0   Inf   Inf   Inf   Inf   Inf     4     6   Inf   Inf     5   Inf   Inf   Inf   Inf   Inf   Inf   Inf     5   Inf   Inf   Inf   Inf   Inf   Inf   Inf   Inf   Inf   Inf   Inf   Inf   Inf   Inf   Inf   Inf   Inf   Inf   Inf   Inf   Inf   Inf   Inf     5   Inf   Inf     2   Inf   Inf   Inf     5   Inf   Inf   Inf   Inf   Inf   Inf   Inf   Inf   Inf   Inf
   Inf     5   Inf   Inf   Inf   Inf   Inf   Inf   Inf     3   Inf     0   Inf   Inf   Inf     7   Inf   Inf   Inf   Inf   Inf   Inf   Inf   Inf   Inf   Inf   Inf   Inf   Inf   Inf   Inf     3   Inf   Inf   Inf   Inf   Inf   Inf   Inf   Inf   Inf   Inf   Inf   Inf   Inf   Inf   Inf   Inf   Inf     5   Inf   Inf   Inf   Inf   Inf   Inf   Inf   Inf   Inf     6   Inf   Inf   Inf   Inf   Inf   Inf   Inf   Inf     3   Inf
   Inf   Inf   Inf   Inf     5   Inf   Inf   Inf   Inf   Inf   Inf   Inf     0   Inf   Inf   Inf   Inf   Inf   Inf   Inf   Inf   Inf   Inf   Inf   Inf     2   Inf     5   Inf   Inf   Inf   Inf   Inf   Inf   Inf   Inf   Inf   Inf   Inf   Inf     9     5   Inf   Inf   Inf   Inf   Inf   Inf   Inf   Inf   Inf   Inf   Inf   Inf   Inf   Inf   Inf   Inf   Inf   Inf   Inf   Inf   Inf   Inf   Inf   Inf   Inf   Inf   Inf   Inf
   Inf   Inf   Inf   Inf   Inf   Inf   Inf   Inf   Inf   Inf   Inf   Inf   Inf     0   Inf   Inf   Inf   Inf   Inf   Inf     6   Inf     5   Inf   Inf   Inf   Inf   Inf   Inf   Inf   Inf   Inf   Inf     4   Inf   Inf   Inf   Inf   Inf   Inf   Inf   Inf   Inf     4   Inf   Inf   Inf   Inf   Inf   Inf     5   Inf   Inf   Inf   Inf   Inf   Inf   Inf   Inf   Inf   Inf   Inf   Inf   Inf   Inf   Inf   Inf   Inf   Inf   Inf
   Inf   Inf     7   Inf   Inf   Inf   Inf   Inf   Inf   Inf   Inf   Inf   Inf   Inf     0   Inf   Inf   Inf   Inf   Inf   Inf   Inf   Inf   Inf   Inf   Inf   Inf   Inf   Inf   Inf   Inf   Inf   Inf   Inf   Inf   Inf   Inf   Inf   Inf   Inf   Inf   Inf   Inf   Inf     5   Inf   Inf   Inf   Inf   Inf   Inf   Inf   Inf   Inf   Inf   Inf   Inf   Inf   Inf   Inf     7     8   Inf   Inf   Inf   Inf   Inf   Inf   Inf   Inf
   Inf   Inf   Inf   Inf   Inf   Inf   Inf   Inf   Inf   Inf   Inf     7   Inf   Inf   Inf     0   Inf   Inf   Inf   Inf   Inf   Inf   Inf   Inf   Inf   Inf   Inf   Inf   Inf   Inf     5   Inf   Inf   Inf   Inf   Inf   Inf   Inf   Inf   Inf   Inf   Inf     3   Inf   Inf   Inf   Inf   Inf   Inf     4   Inf   Inf   Inf   Inf   Inf   Inf   Inf   Inf   Inf   Inf   Inf   Inf     4   Inf   Inf   Inf   Inf   Inf   Inf   Inf
   Inf     3   Inf   Inf   Inf   Inf   Inf   Inf   Inf     6     4   Inf   Inf   Inf   Inf   Inf     0   Inf   Inf   Inf   Inf   Inf   Inf   Inf   Inf   Inf     2   Inf   Inf   Inf   Inf   Inf   Inf   Inf   Inf   Inf   Inf   Inf   Inf   Inf   Inf   Inf   Inf   Inf   Inf   Inf   Inf   Inf   Inf   Inf   Inf   Inf   Inf   Inf   Inf     5   Inf   Inf   Inf   Inf   Inf   Inf   Inf   Inf   Inf   Inf   Inf   Inf   Inf   Inf
   Inf   Inf   Inf   Inf   Inf   Inf   Inf   Inf   Inf     8     6   Inf   Inf   Inf   Inf   Inf   Inf     0   Inf   Inf     4   Inf   Inf   Inf   Inf   Inf   Inf   Inf   Inf   Inf   Inf   Inf   Inf   Inf   Inf   Inf   Inf   Inf   Inf   Inf   Inf   Inf   Inf     5     8   Inf   Inf   Inf   Inf   Inf     8   Inf   Inf   Inf   Inf     6   Inf   Inf   Inf     5     7     4   Inf   Inf   Inf   Inf   Inf   Inf   Inf   Inf
   Inf   Inf   Inf   Inf   Inf     4   Inf   Inf   Inf   Inf   Inf   Inf   Inf   Inf   Inf   Inf   Inf   Inf     0     4   Inf   Inf   Inf   Inf   Inf   Inf   Inf   Inf   Inf   Inf   Inf   Inf     4   Inf   Inf   Inf   Inf     5     5     4   Inf   Inf   Inf   Inf   Inf   Inf   Inf   Inf   Inf   Inf   Inf   Inf   Inf   Inf     2   Inf   Inf   Inf   Inf   Inf   Inf   Inf   Inf   Inf   Inf     4     5     7   Inf     7
   Inf   Inf   Inf     5   Inf   Inf   Inf   Inf   Inf   Inf   Inf   Inf   Inf   Inf   Inf   Inf   Inf   Inf     4     0   Inf   Inf     6   Inf   Inf   Inf   Inf   Inf   Inf     6   Inf   Inf   Inf   Inf   Inf   Inf     5   Inf     2   Inf   Inf   Inf   Inf   Inf   Inf   Inf   Inf   Inf   Inf   Inf   Inf   Inf   Inf   Inf     3   Inf   Inf   Inf   Inf   Inf   Inf   Inf   Inf   Inf   Inf     7     2   Inf   Inf     5
   Inf   Inf   Inf   Inf   Inf   Inf   Inf   Inf   Inf   Inf     5   Inf   Inf     6   Inf   Inf   Inf     4   Inf   Inf     0   Inf   Inf   Inf   Inf   Inf   Inf   Inf   Inf   Inf   Inf   Inf   Inf     6   Inf   Inf   Inf   Inf   Inf   Inf   Inf   Inf   Inf     5   Inf   Inf   Inf   Inf   Inf   Inf   Inf   Inf     5   Inf   Inf     4   Inf   Inf   Inf   Inf   Inf   Inf   Inf   Inf   Inf   Inf   Inf   Inf   Inf   Inf
   Inf   Inf   Inf   Inf   Inf   Inf     7   Inf   Inf   Inf   Inf   Inf   Inf   Inf   Inf   Inf   Inf   Inf   Inf   Inf   Inf     0   Inf   Inf     3   Inf   Inf   Inf   Inf   Inf     5   Inf   Inf   Inf   Inf   Inf   Inf   Inf   Inf   Inf   Inf   Inf   Inf   Inf   Inf   Inf   Inf   Inf   Inf   Inf   Inf   Inf   Inf   Inf   Inf   Inf   Inf   Inf   Inf   Inf   Inf   Inf     6     3   Inf   Inf   Inf   Inf   Inf   Inf
   Inf   Inf   Inf   Inf   Inf   Inf   Inf   Inf   Inf   Inf   Inf   Inf   Inf     5   Inf   Inf   Inf   Inf   Inf     6   Inf   Inf     0   Inf   Inf   Inf   Inf   Inf   Inf   Inf   Inf   Inf   Inf     3   Inf   Inf     5   Inf     5   Inf   Inf   Inf   Inf   Inf   Inf     5   Inf   Inf   Inf   Inf   Inf   Inf   Inf   Inf   Inf   Inf   Inf   Inf   Inf   Inf   Inf   Inf   Inf   Inf   Inf   Inf   Inf   Inf   Inf   Inf
     4   Inf     6     5   Inf   Inf   Inf   Inf   Inf   Inf   Inf   Inf   Inf   Inf   Inf   Inf   Inf   Inf   Inf   Inf   Inf   Inf   Inf     0   Inf   Inf   Inf   Inf   Inf     6   Inf   Inf   Inf   Inf   Inf   Inf   Inf   Inf   Inf   Inf   Inf   Inf   Inf   Inf   Inf   Inf   Inf   Inf   Inf   Inf     5   Inf   Inf   Inf   Inf   Inf   Inf   Inf   Inf   Inf   Inf   Inf   Inf   Inf   Inf   Inf   Inf   Inf   Inf     4
   Inf   Inf   Inf   Inf   Inf   Inf   Inf   Inf   Inf   Inf   Inf   Inf   Inf   Inf   Inf   Inf   Inf   Inf   Inf   Inf   Inf     3   Inf   Inf     0   Inf   Inf   Inf   Inf   Inf     3   Inf   Inf   Inf   Inf   Inf   Inf   Inf   Inf   Inf   Inf   Inf     6   Inf   Inf   Inf   Inf   Inf   Inf   Inf   Inf   Inf   Inf   Inf   Inf   Inf   Inf   Inf   Inf   Inf   Inf   Inf     4     4   Inf   Inf   Inf   Inf   Inf   Inf
   Inf   Inf   Inf   Inf     5   Inf   Inf   Inf   Inf   Inf   Inf   Inf     2   Inf   Inf   Inf   Inf   Inf   Inf   Inf   Inf   Inf   Inf   Inf   Inf     0   Inf     4   Inf   Inf   Inf   Inf   Inf   Inf     6   Inf   Inf   Inf   Inf   Inf   Inf     5   Inf   Inf   Inf   Inf   Inf   Inf   Inf   Inf   Inf   Inf   Inf   Inf   Inf   Inf   Inf     6   Inf   Inf   Inf   Inf   Inf   Inf   Inf   Inf   Inf   Inf   Inf   Inf
   Inf     3   Inf   Inf   Inf   Inf   Inf   Inf     5   Inf   Inf   Inf   Inf   Inf   Inf   Inf     2   Inf   Inf   Inf   Inf   Inf   Inf   Inf   Inf   Inf     0   Inf   Inf   Inf     4   Inf   Inf   Inf   Inf   Inf   Inf   Inf   Inf   Inf   Inf   Inf   Inf   Inf   Inf   Inf   Inf   Inf   Inf     3   Inf   Inf   Inf   Inf   Inf   Inf   Inf   Inf   Inf   Inf   Inf   Inf     7   Inf   Inf   Inf   Inf   Inf   Inf   Inf
   Inf   Inf   Inf   Inf   Inf   Inf   Inf   Inf   Inf   Inf   Inf   Inf     5   Inf   Inf   Inf   Inf   Inf   Inf   Inf   Inf   Inf   Inf   Inf   Inf     4   Inf     0   Inf   Inf   Inf   Inf   Inf   Inf   Inf   Inf   Inf   Inf   Inf   Inf   Inf     6   Inf   Inf   Inf   Inf   Inf   Inf   Inf   Inf   Inf   Inf   Inf   Inf   Inf   Inf   Inf   Inf   Inf   Inf   Inf   Inf   Inf   Inf   Inf   Inf   Inf     6   Inf   Inf
   Inf   Inf   Inf   Inf   Inf   Inf   Inf   Inf     2   Inf     5   Inf   Inf   Inf   Inf   Inf   Inf   Inf   Inf   Inf   Inf   Inf   Inf   Inf   Inf   Inf   Inf   Inf     0   Inf   Inf   Inf   Inf   Inf   Inf   Inf   Inf   Inf   Inf   Inf   Inf   Inf   Inf   Inf   Inf   Inf   Inf   Inf   Inf   Inf   Inf   Inf   Inf   Inf   Inf   Inf     3   Inf   Inf   Inf   Inf   Inf   Inf   Inf   Inf   Inf   Inf   Inf   Inf   Inf
   Inf   Inf   Inf     3   Inf   Inf   Inf   Inf   Inf   Inf   Inf   Inf   Inf   Inf   Inf   Inf   Inf   Inf   Inf     6   Inf   Inf   Inf     6   Inf   Inf   Inf   Inf   Inf     0   Inf   Inf   Inf   Inf   Inf   Inf   Inf   Inf   Inf   Inf   Inf   Inf   Inf   Inf   Inf   Inf   Inf   Inf     3   Inf   Inf   Inf   Inf   Inf   Inf   Inf   Inf   Inf   Inf   Inf   Inf   Inf   Inf   Inf   Inf   Inf     5   Inf   Inf     3
   Inf   Inf   Inf   Inf   Inf   Inf   Inf   Inf   Inf   Inf   Inf   Inf   Inf   Inf   Inf     5   Inf   Inf   Inf   Inf   Inf     5   Inf   Inf     3   Inf     4   Inf   Inf   Inf     0   Inf   Inf   Inf   Inf   Inf   Inf   Inf   Inf   Inf   Inf   Inf     6   Inf   Inf   Inf   Inf   Inf   Inf   Inf   Inf   Inf   Inf   Inf   Inf   Inf   Inf   Inf   Inf   Inf   Inf   Inf     5     5   Inf   Inf   Inf   Inf   Inf   Inf
   Inf     5   Inf   Inf   Inf   Inf   Inf   Inf   Inf     5   Inf     3   Inf   Inf   Inf   Inf   Inf   Inf   Inf   Inf   Inf   Inf   Inf   Inf   Inf   Inf   Inf   Inf   Inf   Inf   Inf     0   Inf   Inf   Inf   Inf   Inf   Inf   Inf   Inf   Inf   Inf   Inf   Inf   Inf   Inf   Inf   Inf   Inf   Inf   Inf   Inf   Inf   Inf   Inf   Inf   Inf   Inf   Inf   Inf   Inf   Inf   Inf   Inf   Inf   Inf   Inf   Inf   Inf   Inf
   Inf   Inf   Inf   Inf   Inf     5   Inf   Inf   Inf   Inf   Inf   Inf   Inf   Inf   Inf   Inf   Inf   Inf     4   Inf   Inf   Inf   Inf   Inf   Inf   Inf   Inf   Inf   Inf   Inf   Inf   Inf     0   Inf   Inf   Inf   Inf     5   Inf     3   Inf   Inf   Inf   Inf   Inf   Inf   Inf   Inf   Inf   Inf   Inf   Inf   Inf   Inf     5   Inf   Inf   Inf   Inf   Inf   Inf   Inf   Inf   Inf   Inf     4   Inf   Inf   Inf   Inf
   Inf   Inf   Inf   Inf   Inf   Inf   Inf   Inf   Inf   Inf   Inf   Inf   Inf     4   Inf   Inf   Inf   Inf   Inf   Inf     6   Inf     3   Inf   Inf   Inf   Inf   Inf   Inf   Inf   Inf   Inf   Inf     0   Inf   Inf   Inf   Inf   Inf   Inf   Inf   Inf   Inf     6   Inf   Inf   Inf   Inf   Inf   Inf     7   Inf   Inf   Inf   Inf   Inf   Inf   Inf     5   Inf   Inf   Inf   Inf   Inf   Inf   Inf   Inf   Inf   Inf   Inf
   Inf   Inf   Inf   Inf   Inf   Inf   Inf   Inf   Inf   Inf   Inf   Inf   Inf   Inf   Inf   Inf   Inf   Inf   Inf   Inf   Inf   Inf   Inf   Inf   Inf     6   Inf   Inf   Inf   Inf   Inf   Inf   Inf   Inf     0     3   Inf   Inf   Inf   Inf   Inf     3   Inf   Inf   Inf     5   Inf   Inf   Inf   Inf   Inf     4   Inf   Inf   Inf   Inf   Inf     2     4   Inf   Inf   Inf   Inf   Inf   Inf   Inf   Inf   Inf   Inf   Inf
   Inf   Inf   Inf   Inf   Inf   Inf     6   Inf   Inf   Inf   Inf   Inf   Inf   Inf   Inf   Inf   Inf   Inf   Inf   Inf   Inf   Inf   Inf   Inf   Inf   Inf   Inf   Inf   Inf   Inf   Inf   Inf   Inf   Inf     3     0   Inf   Inf   Inf   Inf   Inf     5   Inf   Inf   Inf   Inf   Inf   Inf   Inf   Inf   Inf     2   Inf   Inf   Inf   Inf   Inf     3     4   Inf   Inf   Inf   Inf   Inf     4   Inf   Inf   Inf   Inf   Inf
   Inf   Inf   Inf   Inf   Inf   Inf   Inf   Inf   Inf   Inf   Inf   Inf   Inf   Inf   Inf   Inf   Inf   Inf   Inf     5   Inf   Inf     5   Inf   Inf   Inf   Inf   Inf   Inf   Inf   Inf   Inf   Inf   Inf   Inf   Inf     0   Inf     4   Inf   Inf     6   Inf   Inf   Inf     3   Inf   Inf   Inf   Inf   Inf   Inf   Inf   Inf     5   Inf   Inf   Inf   Inf   Inf   Inf   Inf   Inf   Inf   Inf   Inf   Inf   Inf   Inf   Inf
   Inf   Inf   Inf   Inf   Inf     2   Inf   Inf   Inf   Inf   Inf   Inf   Inf   Inf   Inf   Inf   Inf   Inf     5   Inf   Inf   Inf   Inf   Inf   Inf   Inf   Inf   Inf   Inf   Inf   Inf   Inf     5   Inf   Inf   Inf   Inf     0   Inf   Inf   Inf   Inf   Inf   Inf   Inf   Inf   Inf   Inf   Inf   Inf   Inf   Inf   Inf   Inf   Inf   Inf   Inf   Inf   Inf   Inf   Inf   Inf   Inf   Inf   Inf     2   Inf     4   Inf   Inf
   Inf   Inf   Inf     5   Inf   Inf   Inf   Inf   Inf   Inf   Inf   Inf   Inf   Inf   Inf   Inf   Inf   Inf     5     2   Inf   Inf     5   Inf   Inf   Inf   Inf   Inf   Inf   Inf   Inf   Inf   Inf   Inf   Inf   Inf     4   Inf     0   Inf   Inf   Inf   Inf   Inf   Inf   Inf   Inf   Inf   Inf   Inf   Inf   Inf   Inf   Inf     4   Inf   Inf   Inf   Inf   Inf   Inf   Inf   Inf   Inf   Inf   Inf     3   Inf   Inf     5
   Inf   Inf   Inf   Inf   Inf   Inf   Inf   Inf   Inf   Inf   Inf   Inf   Inf   Inf   Inf   Inf   Inf   Inf     4   Inf   Inf   Inf   Inf   Inf   Inf   Inf   Inf   Inf   Inf   Inf   Inf   Inf     3   Inf   Inf   Inf   Inf   Inf   Inf     0   Inf   Inf   Inf   Inf   Inf   Inf   Inf   Inf     4   Inf   Inf   Inf   Inf   Inf   Inf   Inf   Inf   Inf   Inf   Inf   Inf   Inf   Inf   Inf   Inf     6   Inf   Inf   Inf   Inf
   Inf   Inf   Inf   Inf     5   Inf   Inf     2   Inf   Inf   Inf   Inf     9   Inf   Inf   Inf   Inf   Inf   Inf   Inf   Inf   Inf   Inf   Inf   Inf   Inf   Inf   Inf   Inf   Inf   Inf   Inf   Inf   Inf   Inf   Inf   Inf   Inf   Inf   Inf     0   Inf   Inf   Inf   Inf   Inf     2     8   Inf   Inf   Inf   Inf   Inf     5   Inf   Inf   Inf   Inf   Inf   Inf   Inf   Inf   Inf   Inf   Inf   Inf   Inf   Inf   Inf   Inf
   Inf   Inf   Inf   Inf   Inf   Inf   Inf   Inf   Inf   Inf   Inf   Inf     5   Inf   Inf   Inf   Inf   Inf   Inf   Inf   Inf   Inf   Inf   Inf   Inf     5   Inf     6   Inf   Inf   Inf   Inf   Inf   Inf     3     5     6   Inf   Inf   Inf   Inf     0   Inf   Inf   Inf     4   Inf   Inf   Inf   Inf   Inf     6   Inf   Inf   Inf   Inf   Inf     4     5   Inf   Inf   Inf   Inf   Inf   Inf   Inf   Inf   Inf   Inf   Inf
   Inf   Inf   Inf   Inf   Inf   Inf   Inf   Inf   Inf   Inf   Inf   Inf   Inf   Inf   Inf     3   Inf   Inf   Inf   Inf   Inf   Inf   Inf   Inf     6   Inf   Inf   Inf   Inf   Inf     6   Inf   Inf   Inf   Inf   Inf   Inf   Inf   Inf   Inf   Inf   Inf     0   Inf   Inf   Inf   Inf   Inf   Inf     6   Inf   Inf   Inf   Inf   Inf   Inf   Inf   Inf   Inf   Inf   Inf   Inf     3   Inf   Inf   Inf   Inf   Inf   Inf   Inf
   Inf   Inf   Inf   Inf   Inf   Inf   Inf   Inf   Inf   Inf   Inf   Inf   Inf     4   Inf   Inf   Inf     5   Inf   Inf     5   Inf   Inf   Inf   Inf   Inf   Inf   Inf   Inf   Inf   Inf   Inf   Inf     6   Inf   Inf   Inf   Inf   Inf   Inf   Inf   Inf   Inf     0   Inf   Inf   Inf   Inf   Inf   Inf     4   Inf   Inf   Inf   Inf   Inf   Inf   Inf   Inf   Inf   Inf     6   Inf   Inf   Inf   Inf   Inf   Inf   Inf   Inf
   Inf   Inf   Inf   Inf   Inf   Inf   Inf   Inf   Inf   Inf   Inf   Inf   Inf   Inf     5   Inf   Inf     8   Inf   Inf   Inf   Inf   Inf   Inf   Inf   Inf   Inf   Inf   Inf   Inf   Inf   Inf   Inf   Inf   Inf   Inf   Inf   Inf   Inf   Inf   Inf   Inf   Inf   Inf     0   Inf   Inf   Inf   Inf   Inf   Inf   Inf   Inf   Inf   Inf   Inf   Inf   Inf   Inf   Inf     3     5   Inf   Inf   Inf   Inf   Inf   Inf   Inf   Inf
   Inf   Inf   Inf   Inf   Inf   Inf   Inf   Inf   Inf   Inf   Inf   Inf   Inf   Inf   Inf   Inf   Inf   Inf   Inf   Inf   Inf   Inf     5   Inf   Inf   Inf   Inf   Inf   Inf   Inf   Inf   Inf   Inf   Inf     5   Inf     3   Inf   Inf   Inf   Inf     4   Inf   Inf   Inf     0   Inf   Inf   Inf   Inf   Inf   Inf   Inf   Inf   Inf   Inf   Inf   Inf     5   Inf   Inf   Inf   Inf   Inf   Inf   Inf   Inf   Inf   Inf   Inf
   Inf   Inf   Inf   Inf   Inf   Inf   Inf     3   Inf   Inf   Inf   Inf   Inf   Inf   Inf   Inf   Inf   Inf   Inf   Inf   Inf   Inf   Inf   Inf   Inf   Inf   Inf   Inf   Inf   Inf   Inf   Inf   Inf   Inf   Inf   Inf   Inf   Inf   Inf   Inf     2   Inf   Inf   Inf   Inf   Inf     0   Inf   Inf   Inf   Inf   Inf   Inf     5   Inf   Inf   Inf   Inf   Inf   Inf   Inf   Inf   Inf   Inf   Inf   Inf   Inf   Inf   Inf   Inf
   Inf   Inf   Inf   Inf   Inf   Inf     6     7   Inf   Inf   Inf   Inf   Inf   Inf   Inf   Inf   Inf   Inf   Inf   Inf   Inf   Inf   Inf   Inf   Inf   Inf   Inf   Inf   Inf   Inf   Inf   Inf   Inf   Inf   Inf   Inf   Inf   Inf   Inf   Inf     8   Inf   Inf   Inf   Inf   Inf   Inf     0   Inf   Inf   Inf   Inf   Inf     5   Inf   Inf   Inf   Inf   Inf   Inf   Inf   Inf   Inf   Inf   Inf   Inf   Inf   Inf   Inf   Inf
   Inf   Inf   Inf     4   Inf   Inf   Inf   Inf   Inf   Inf   Inf   Inf   Inf   Inf   Inf   Inf   Inf   Inf   Inf   Inf   Inf   Inf   Inf   Inf   Inf   Inf   Inf   Inf   Inf     3   Inf   Inf   Inf   Inf   Inf   Inf   Inf   Inf   Inf     4   Inf   Inf   Inf   Inf   Inf   Inf   Inf   Inf     0   Inf   Inf   Inf   Inf   Inf   Inf   Inf   Inf   Inf   Inf   Inf   Inf   Inf   Inf   Inf   Inf   Inf     5   Inf   Inf     5
   Inf     3   Inf   Inf   Inf   Inf   Inf   Inf   Inf     6   Inf     5   Inf   Inf   Inf     4   Inf   Inf   Inf   Inf   Inf   Inf   Inf   Inf   Inf   Inf     3   Inf   Inf   Inf   Inf   Inf   Inf   Inf   Inf   Inf   Inf   Inf   Inf   Inf   Inf   Inf     6   Inf   Inf   Inf   Inf   Inf   Inf     0   Inf   Inf   Inf   Inf   Inf   Inf   Inf   Inf   Inf   Inf   Inf   Inf     6   Inf   Inf   Inf   Inf   Inf   Inf   Inf
     5   Inf     4   Inf   Inf   Inf   Inf   Inf   Inf   Inf   Inf   Inf   Inf     5   Inf   Inf   Inf     8   Inf   Inf   Inf   Inf   Inf     5   Inf   Inf   Inf   Inf   Inf   Inf   Inf   Inf   Inf     7   Inf   Inf   Inf   Inf   Inf   Inf   Inf   Inf   Inf     4   Inf   Inf   Inf   Inf   Inf   Inf     0   Inf   Inf   Inf   Inf   Inf   Inf   Inf   Inf   Inf   Inf   Inf   Inf   Inf   Inf   Inf   Inf   Inf   Inf   Inf
   Inf   Inf   Inf   Inf   Inf   Inf   Inf   Inf     5   Inf   Inf   Inf   Inf   Inf   Inf   Inf   Inf   Inf   Inf   Inf   Inf   Inf   Inf   Inf   Inf   Inf   Inf   Inf   Inf   Inf   Inf   Inf   Inf   Inf     4     2   Inf   Inf   Inf   Inf   Inf     6   Inf   Inf   Inf   Inf   Inf   Inf   Inf   Inf   Inf     0   Inf   Inf   Inf   Inf     4     4     4   Inf   Inf   Inf   Inf   Inf     3   Inf   Inf   Inf   Inf   Inf
   Inf   Inf   Inf   Inf   Inf   Inf   Inf   Inf     4   Inf     5   Inf   Inf   Inf   Inf   Inf   Inf   Inf   Inf   Inf     5   Inf   Inf   Inf   Inf   Inf   Inf   Inf   Inf   Inf   Inf   Inf   Inf   Inf   Inf   Inf   Inf   Inf   Inf   Inf   Inf   Inf   Inf   Inf   Inf   Inf   Inf   Inf   Inf   Inf   Inf   Inf     0   Inf   Inf     4   Inf   Inf   Inf   Inf   Inf   Inf   Inf   Inf     3   Inf   Inf   Inf   Inf   Inf
   Inf   Inf   Inf   Inf     5   Inf   Inf     4   Inf   Inf   Inf   Inf   Inf   Inf   Inf   Inf   Inf   Inf   Inf   Inf   Inf   Inf   Inf   Inf   Inf   Inf   Inf   Inf   Inf   Inf   Inf   Inf   Inf   Inf   Inf   Inf   Inf   Inf   Inf   Inf     5   Inf   Inf   Inf   Inf   Inf     5     5   Inf   Inf   Inf   Inf   Inf     0   Inf   Inf   Inf   Inf   Inf   Inf   Inf   Inf   Inf   Inf   Inf   Inf   Inf   Inf   Inf   Inf
   Inf   Inf   Inf   Inf   Inf     4   Inf   Inf   Inf   Inf   Inf   Inf   Inf   Inf   Inf   Inf   Inf   Inf     2     3   Inf   Inf   Inf   Inf   Inf   Inf   Inf   Inf   Inf   Inf   Inf   Inf     5   Inf   Inf   Inf     5   Inf     4   Inf   Inf   Inf   Inf   Inf   Inf   Inf   Inf   Inf   Inf   Inf   Inf   Inf   Inf   Inf     0   Inf   Inf   Inf   Inf   Inf   Inf   Inf   Inf   Inf   Inf     5     4   Inf   Inf   Inf
   Inf   Inf   Inf   Inf   Inf   Inf   Inf   Inf     5   Inf     2   Inf   Inf   Inf   Inf   Inf     5     6   Inf   Inf     4   Inf   Inf   Inf   Inf   Inf   Inf   Inf   Inf   Inf   Inf   Inf   Inf   Inf   Inf   Inf   Inf   Inf   Inf   Inf   Inf   Inf   Inf   Inf   Inf   Inf   Inf   Inf   Inf   Inf   Inf   Inf     4   Inf   Inf     0   Inf   Inf   Inf   Inf   Inf   Inf   Inf   Inf   Inf   Inf   Inf   Inf   Inf   Inf
   Inf   Inf   Inf   Inf   Inf   Inf     5   Inf     3   Inf   Inf   Inf   Inf   Inf   Inf   Inf   Inf   Inf   Inf   Inf   Inf   Inf   Inf   Inf   Inf   Inf   Inf   Inf     3   Inf   Inf   Inf   Inf   Inf   Inf   Inf   Inf   Inf   Inf   Inf   Inf   Inf   Inf   Inf   Inf   Inf   Inf   Inf   Inf   Inf   Inf     4   Inf   Inf   Inf   Inf     0   Inf   Inf   Inf   Inf   Inf   Inf   Inf   Inf   Inf   Inf   Inf   Inf   Inf
   Inf   Inf   Inf   Inf   Inf   Inf   Inf   Inf   Inf   Inf   Inf   Inf   Inf   Inf   Inf   Inf   Inf   Inf   Inf   Inf   Inf   Inf   Inf   Inf   Inf     6   Inf   Inf   Inf   Inf   Inf   Inf   Inf   Inf     2     3   Inf   Inf   Inf   Inf   Inf     4   Inf   Inf   Inf   Inf   Inf   Inf   Inf   Inf   Inf     4   Inf   Inf   Inf   Inf   Inf     0     5   Inf   Inf   Inf   Inf   Inf   Inf   Inf   Inf   Inf   Inf   Inf
   Inf   Inf   Inf   Inf   Inf   Inf   Inf   Inf   Inf   Inf   Inf   Inf   Inf   Inf   Inf   Inf   Inf   Inf   Inf   Inf   Inf   Inf   Inf   Inf   Inf   Inf   Inf   Inf   Inf   Inf   Inf   Inf   Inf     5     4     4   Inf   Inf   Inf   Inf   Inf     5   Inf   Inf   Inf     5   Inf   Inf   Inf   Inf   Inf     4   Inf   Inf   Inf   Inf   Inf     5     0   Inf   Inf   Inf   Inf   Inf     3   Inf   Inf   Inf   Inf   Inf
   Inf     5   Inf   Inf   Inf   Inf   Inf   Inf   Inf     4     5     6   Inf   Inf   Inf   Inf   Inf     5   Inf   Inf   Inf   Inf   Inf   Inf   Inf   Inf   Inf   Inf   Inf   Inf   Inf   Inf   Inf   Inf   Inf   Inf   Inf   Inf   Inf   Inf   Inf   Inf   Inf   Inf   Inf   Inf   Inf   Inf   Inf   Inf   Inf   Inf   Inf   Inf   Inf   Inf   Inf   Inf   Inf     0   Inf   Inf   Inf   Inf   Inf   Inf   Inf   Inf     4   Inf
   Inf   Inf   Inf   Inf   Inf   Inf   Inf   Inf   Inf   Inf   Inf   Inf   Inf   Inf     7   Inf   Inf     7   Inf   Inf   Inf   Inf   Inf   Inf   Inf   Inf   Inf   Inf   Inf   Inf   Inf   Inf   Inf   Inf   Inf   Inf   Inf   Inf   Inf   Inf   Inf   Inf   Inf   Inf     3   Inf   Inf   Inf   Inf   Inf   Inf   Inf   Inf   Inf   Inf   Inf   Inf   Inf   Inf   Inf     0     4   Inf   Inf   Inf   Inf   Inf   Inf   Inf   Inf
   Inf   Inf   Inf   Inf   Inf   Inf   Inf   Inf   Inf   Inf   Inf   Inf   Inf   Inf     8   Inf   Inf     4   Inf   Inf   Inf   Inf   Inf   Inf   Inf   Inf   Inf   Inf   Inf   Inf   Inf   Inf   Inf   Inf   Inf   Inf   Inf   Inf   Inf   Inf   Inf   Inf   Inf     6     5   Inf   Inf   Inf   Inf   Inf   Inf   Inf   Inf   Inf   Inf   Inf   Inf   Inf   Inf   Inf     4     0   Inf   Inf   Inf   Inf   Inf   Inf   Inf   Inf
   Inf   Inf   Inf   Inf   Inf   Inf   Inf   Inf   Inf   Inf   Inf   Inf   Inf   Inf   Inf     4   Inf   Inf   Inf   Inf   Inf     6   Inf   Inf     4   Inf     7   Inf   Inf   Inf     5   Inf   Inf   Inf   Inf   Inf   Inf   Inf   Inf   Inf   Inf   Inf     3   Inf   Inf   Inf   Inf   Inf   Inf     6   Inf   Inf   Inf   Inf   Inf   Inf   Inf   Inf   Inf   Inf   Inf   Inf     0   Inf   Inf   Inf   Inf   Inf   Inf   Inf
   Inf   Inf   Inf   Inf   Inf   Inf     5   Inf   Inf   Inf   Inf   Inf   Inf   Inf   Inf   Inf   Inf   Inf   Inf   Inf   Inf     3   Inf   Inf     4   Inf   Inf   Inf   Inf   Inf     5   Inf   Inf   Inf   Inf   Inf   Inf   Inf   Inf   Inf   Inf   Inf   Inf   Inf   Inf   Inf   Inf   Inf   Inf   Inf   Inf   Inf   Inf   Inf   Inf   Inf   Inf   Inf   Inf   Inf   Inf   Inf   Inf     0   Inf   Inf   Inf   Inf   Inf   Inf
   Inf   Inf   Inf   Inf   Inf   Inf   Inf   Inf   Inf   Inf   Inf   Inf   Inf   Inf   Inf   Inf   Inf   Inf   Inf   Inf   Inf   Inf   Inf   Inf   Inf   Inf   Inf   Inf   Inf   Inf   Inf   Inf   Inf   Inf   Inf     4   Inf   Inf   Inf   Inf   Inf   Inf   Inf   Inf   Inf   Inf   Inf   Inf   Inf   Inf   Inf     3     3   Inf   Inf   Inf   Inf   Inf     3   Inf   Inf   Inf   Inf   Inf     0   Inf   Inf   Inf   Inf   Inf
   Inf   Inf   Inf   Inf   Inf     2   Inf   Inf   Inf   Inf   Inf   Inf   Inf   Inf   Inf   Inf   Inf   Inf     4     7   Inf   Inf   Inf   Inf   Inf   Inf   Inf   Inf   Inf   Inf   Inf   Inf     4   Inf   Inf   Inf   Inf     2   Inf     6   Inf   Inf   Inf   Inf   Inf   Inf   Inf   Inf   Inf   Inf   Inf   Inf   Inf   Inf     5   Inf   Inf   Inf   Inf   Inf   Inf   Inf   Inf   Inf   Inf     0   Inf     5   Inf   Inf
   Inf   Inf   Inf     3   Inf   Inf   Inf   Inf   Inf   Inf   Inf   Inf   Inf   Inf   Inf   Inf   Inf   Inf     5     2   Inf   Inf   Inf   Inf   Inf   Inf   Inf   Inf   Inf     5   Inf   Inf   Inf   Inf   Inf   Inf   Inf   Inf     3   Inf   Inf   Inf   Inf   Inf   Inf   Inf   Inf   Inf     5   Inf   Inf   Inf   Inf   Inf     4   Inf   Inf   Inf   Inf   Inf   Inf   Inf   Inf   Inf   Inf   Inf     0   Inf   Inf     4
   Inf   Inf   Inf   Inf   Inf     4   Inf   Inf   Inf   Inf   Inf   Inf   Inf   Inf   Inf   Inf   Inf   Inf     7   Inf   Inf   Inf   Inf   Inf   Inf   Inf   Inf     6   Inf   Inf   Inf   Inf   Inf   Inf   Inf   Inf   Inf     4   Inf   Inf   Inf   Inf   Inf   Inf   Inf   Inf   Inf   Inf   Inf   Inf   Inf   Inf   Inf   Inf   Inf   Inf   Inf   Inf   Inf   Inf   Inf   Inf   Inf   Inf   Inf     5   Inf     0   Inf   Inf
   Inf     5   Inf   Inf   Inf   Inf   Inf   Inf   Inf     1   Inf     3   Inf   Inf   Inf   Inf   Inf   Inf   Inf   Inf   Inf   Inf   Inf   Inf   Inf   Inf   Inf   Inf   Inf   Inf   Inf   Inf   Inf   Inf   Inf   Inf   Inf   Inf   Inf   Inf   Inf   Inf   Inf   Inf   Inf   Inf   Inf   Inf   Inf   Inf   Inf   Inf   Inf   Inf   Inf   Inf   Inf   Inf   Inf     4   Inf   Inf   Inf   Inf   Inf   Inf   Inf   Inf     0   Inf
     6   Inf   Inf     2   Inf   Inf   Inf   Inf   Inf   Inf   Inf   Inf   Inf   Inf   Inf   Inf   Inf   Inf     7     5   Inf   Inf   Inf     4   Inf   Inf   Inf   Inf   Inf     3   Inf   Inf   Inf   Inf   Inf   Inf   Inf   Inf     5   Inf   Inf   Inf   Inf   Inf   Inf   Inf   Inf   Inf     5   Inf   Inf   Inf   Inf   Inf   Inf   Inf   Inf   Inf   Inf   Inf   Inf   Inf   Inf   Inf   Inf   Inf     4   Inf   Inf     0
